111111111111111111111111
1P0000000001111111111001
100000000000000000000001
111111110000000000000001
111111111100C01111100001
100000111100001111100001
100000110000000001100001
100C00110000000001100001
100000000001111111100001
100000000001111111100001
100000000001100000000001
100000000001100E00000001
11100111100110000000C001
111001111000000000000001
100000C11000000000000001
100000011000011110011001
100000011000011110011001
100000000000011000000001
100000000000011000000001
111111111111111111111111