1111111111111111111111
1P00000C00000000000001
1000000000000C00000001
1000000000000000000001
1000000000C00000000001
1000000000000000C00001
10C000000000E000000001
1000000000000000000001
10000000C000000C000001
1000000000000000000001
1111111111111111111111